NO textures/test/north.xpm
SO textures/test/south.xpm
WE textures/test/west.xpm
EA textures/test/east.xpm

F 146,116,91
C 135,206,235

                       111111111111111111111111111111111111111111111111111111111111                 
                     111000000000000000000000000000000000000000000000000000000000001111             
                  11110000000000000000000000000000000000000000000000000000000000000000111           
                11100000000000000000000000000000000000000000000000000000000000000000000011          
            1111100000000000000000000000000000000000000000000000000000000000000000000000011         
       1111110000000000000000000000000000000000000000000000000000000000000000000000000000011        
     1110000000000000000000000000000000000000000000000000000000000000000000000000000000000011       
    11000000000000000000000000000000000000000000000000000000000000000000000000000000000000001       
    100000000000000000000000000000000000000000000000000000000000000000000000000000000000000011      
   1100000000000000000000000000000000000000000000000000000000000000000000000000000000000000001      
   10000000000000000000000000000000000000000000000000000000000000000000000000000000000000000001     
  1100000000000000000000000000000000000000000000000000000000000000000000000000000000000000000011    
 11000000000000000000000000000000000000000000000000000000000000000000000000000000000000000000001    
1100000000000000000000000000000000000000000000000000000000000000000000000000000000000000000000011   
1000000000000000000000000000000000000000000000000000000000000000000000000000000000000000000000001   
10000000000000000000000000000000000000000000000000000000000000000000000000000000000000000000000001  
10000000000000000000000000000000000000000000000000000000000000000000000000000000000000000000000001  
100000000000000000000000000000000000000000000000000000000000000000000000000000000000000000000000001 
100000000000000000000000000000000000000000000000000000000000000000000000000000000000000000000000001 
1000000000000000000000000000000000000000000000000000000000000000000000000000000000000000000000000001
1000000000000000000000000000000000000000000000000000000000000000000000000000000000000000000000000001
1000000000000000000000000000000000000000000000000000000000000000000000000000000000000000000000000001
1000000000000000000000000000000000000000000000000000000000000000000000000000000000000000000000000001
1000000000000000000000000000000000000000000000000000000000000000000000000000000000000000000000000001
1000000000000000000000000000000000000000000000000000000000000000000000000000000000000000000000000001
1000000000000000000000000000000000000000000000000000000000000000000000000000000000000000000000000001
1000000000000000000000000000000000000000000000000000000000011111111111111111111000000000000000000001
1000001000000000000000000000000000000000000000000000000001110000000000000000000110000000000000000001
1000001100000000000000000000000001100000000000000000000011000000000000000000000010000000000000000001
1000001100000000000000000000000001100000000000000000000110000000000000000000000000000000000000000001
1000001110000000000000000000000011100000000000000000001100000000000000000000000000000000000000000011
100000101000000000000000000000001100000000000000000000100000000000000000000000000000000000000000001 
100000101100000000000000000000010100000000000000000000100000000000000000000000000000000000000000001 
100000100100000000000000000000010100000000000000000000100000000000000000000000000000000000000000001 
100000100100000000000000000000100100000000000000000000100000000000000000000000000000000000000000001 
100000100100000000000000000001101100000000000000000000100000000000000000000000000000000000000000001 
100000100110000000000000000001001000000000000000000000100000000000000000000000000000000000000000001 
100000100010000000000000000010001000000000000000000000110000000000000000000000000000000000000000001 
100000100011000000000000000010001000000000000000000000011000000000000000000000000000000000000000001 
100000100001000000000000000100001000000000000000000000001100000000000000000000000000000000000000001 
100000100001100000000000001100001000000000000000000000000110000000000000000000000000000000000000001 
100000100000100000000000001000001000000000000000000000000001110000000000000000000000000000000000001 
100000100000110000000000011000001000000000000000000000000000011111111111111000000000000000000000001 
100000100000011000000000010000010000000000000000000000000000000000000000001111000000000000000000001 
100000100000001000000000010000010000000000000000000000000000000000000000000001100000000000000000001 
100000100000000100000000100000010000000000000000000000000000000000000000000000110000000000000000011 
10000010000000011000000010000001000000000000000000000000000000000000000000000001000000000000000001  
10000010000000001000000010000001000000000000000000000000000000000000000000000001000000000000000001  
10000010000000000100000110000001000000000000000000000000000000000000000000000001100000000000000011  
1000001000000000001000010000000100000000000000000000000000000000000000000000000010000000000000001   
1000001000000000001100010000000100000000000000000000000000000000000000000000000010000000000000011   
100000100000000000011011000000010000000000000000000000000000000000000000000000001000000000000001    
100000100000000000001010000000010000000000000000000000000000000000000000000000001000000000000011    
10000010000000000000011000000001000000000000000000000000000000000000000000000000100000000000001     
10000010000000000000000000000001000000000000000000000000000000000000000000000000100000000000011     
1000001000000000000000000000000100000000000000000000000000000000000000000000000010000000000001      
1000001000000000000000000000000100000000000000000000000000000000000000000000000010000000000011      
100000100000000000000000000000010000000000000000000000000000000000000000000000001000000000011       
10000010000000000000000000000011000000000000000000000000000000000000000000000000100000000001        
10000001000000000000000000000010000000000000000000000000000000000000000000000000100000000011        
1000000100000000000000000000001000000000000000000000000000000000000000000000000010000000011         
100000010000000000000000000000100000000000000000000000000000000000000000000000011000000011          
10000001000000000000000000000010000000000000000000000000000000000000000000000001000000011           
1000000100000000000000000000001000000000000000000000000000000000000000000000000100000001            
1000000100000000000000000000001000000000000000000000000000000000000000000000001100000001            
1000000100000000000000000000001000000000000000000000000000000000000000000000001000000001            
1000000100000000000000000000001000000000000000000000000000000000000000000000011000000001            
1000000100000000000000000000001000000000000000000000000000000000000000000000110000000001            
10000001000000000000000000000010000000000000000000000000000000000000000000011000000000001           
100000001000000000000000000000110000000000000000111111111111111111111111111100000000000011          
1000000010000000000000000000001100000000000000000000000000000000000000000000000000000000011         
10000000100000000000000000000000000000000000000000000000000000000000000000000000000000000011        
100000000000000000000000000000000000000000000000000000000000000000000000000000000000000000011       
100000000000000000000000000000000000000000000000000000000000000000000000000000000000000000001       
1000000000000000000000000000000000000000000000000000000000000000000000000000000000000000000001      
10000000000000000000000000000000000000000000000000000000000000000000000000000000000000000000011     
10000000000000000000000000000000000000000000000000000000000000000000000000000000000000000000001     
100000000000000000000000000000000000000000000000000000000000000000000000000000000000000000000011    
1000000000000000000000000000000000000000000000000000000000000000000000000000000000000000000000011   
1000000000000000000000000000000000000000000000000000000000000000000000000000000000000000000000001   
10000000000000000000000000000000000000000000000000000000000000000000000000000000000000000000000011  
10000000000000000000000000000000000000000000000000000000000000000000000000000000000000000000000001  
100000000000000000000000000000000000000000000000000000000000000000000000000000000000000000000000011 
110000000000000000000000000000000000000000000000000000000000000000000000000000000000000000000000001 
 11000000000000000000000000000000000000000000000000000000000000000000000000000000000000000000000001 
  1110000000000000000000000000000000000000000000000000000000000000000000000000000000000000000000001 
    11100000000000000000000000000000000000000000000000000000000000000000000000000000000000000000001 
      1110000000000000000000000000000000000N0000000000000000000000000000000000000000000000000000001 
        1110000000000000000000000000000000000000000000000000000000000000000000000000000000000000001 
          11100000000000000000000000000000000000000000000000000000000000000000000000000000000000001 
             11111111111110000000000000000000000000000000000000000000000000000000000000000000000001 
                          1111111000000000000000000000000000000000000000000000000000000000000000001 
                                1111110000000000000000000000000000000000000000000000000000000000001 
                                      1111111110000000000000000000000000000000000000000000000000001 
                                               1111111111000000000000000000000000000000000000000001 
                                                        1110000000000000000000000000000000000000001 
                                                           1110000000000000000000000000000000000001 
                                                             11100000000000000000000000000000000001 
                                                               111100000000000000000000000000000001 
                                                                  1111111111111111111111111111111111

