NO textures/wolfenstein/grey_stone.xpm
SO textures/wolfenstein/grey_stone.xpm
WE textures/wolfenstein/mossy.xpm
EA textures/wolfenstein/mossy.xpm

F 146,116,91
C 135,206,235

     1111111111     
    11000000001     
 11110000000001     
1100000000000011    
10000000000000011111
 1000000000000000001
 1000000000000000001
 1000000000000000001
 1000011111110000011
 100001000001000001 
 100001000001000001 
 100001000001000001 
 1000010000010000011
 1000100000010000001
 1000100000010000001
 1000111121110000001
 1000000000000000111
110000000000000001  
100000000N00000001  
 11111111111111111  

